4444444444444444444
4111111114111111114
4544144414144414454
4111111111111111114
4144141444441414414
4111141114111411114
4444144404044414444
0004140000000414000
0004140443440414000
0004100433340014000
0004140444440414000
0004140000000414000
4444140444440414444
4111111114111111114
4144144414144414414
4514111112111114154
4414141444441414144
4111141114111411114
4144444414144444414
4111111111111111114
4444444444444444444