00000000000000000000
01110010011001001110
01110010000001001110
01110010000001001110
00000010011001000000
01111110011001111110
01000000000000000010
01001111100111110010
00000022230000000000
01111100111100111110
00000000111100000000
00000000111100000000
01111000000000011110
01111001111110011110
01111000000000011110
00000010111101000000
00000010111101000000
00000010111101000000
01111110000001111110
00000000000000000000